11111111111111111
1C00000E000000011
11110100000C00001
1001C00000C000001
10001000000000001
100000P0000000001
11111111111111111
